OOOOXOOOOXOOOOXOOOOX
OOOOXOOOOOOOOOOOOOOX
OOOOXOOOOOOOXXXOXXXX
OOOOXOOOOOOOOXOOOOOO
OOOOXOOOOOOOOXOOOOOO
OOOOXOOOOOOOOXOOOOOO
OOOOOOOOOOOOOXOOOOOO
OOOOOOOOOOOOOXOOOOOO
XXXXXOOOOOOOOXXXXOOO
OOOOOOOOOOOOOOOOOOOO
OOXXOOOOOOOOOOOOOXOO
OOOXXOOOOOOOOOOOOXOO
OOOXXOOOOOOOOOOOOXOO
OOOXXOOOOOOOOOOOOXOO
OOOOXOOOOOOOOOOOOXOO
XOOOXOOOOOOOXXXXXXOO
XOOOOOOOOOOOOOOOOOOO
XXXXXXXXXOOOOOOOOOOO
OOOOOOOOOOOOOOOOOOOO
OOOXXXOOOOOOOOOOOOOO